##########
^^^^^^^^^^
%
FFFFFFFFFF
DDDDDDDDDD
**********

