############################################
#                                          #
#  ^*                    #####             #
#                        #                 #
#          ###D#####     # %               #
#                  #     #                 #
#              *   #     #####             #
#          #####D###                       #
#                          D               #
#                         *                #
#              $                           #
#   F                                      #
#                                          #
############################################
