############################################
#                                          #
#  ^*                    #####             #
#                        #                 #
#          ###D#####     # %               #
#          #       #     #                 #
#          #   *   #     #####             #
#          #####D###                       #
#                          D               #
#                         *                #
#              $                           #
#   F                                      #
#                                          #
############################################
