^^^^^^^^^^
%     ##  
FFF      F
D D D  D D
**   * ***

